27	
addressee	none
appellant	none
appellee	none
consultant	none
court governed	none
dedicatee	none
dedicator	none
defendant	none
degree granting institution	none
degree supervisor	none
director	N: film director, readio director, television director
film director	director
radio director	director
television director	director
director of photography	none
honouree	none
host institution	none
issuing body	none
judge	none
jurisdiction governed	none
plaintiff	none
producer	N: film producer, radio producer, television producer
film producer	B: producer
radio producer	B: producer
television producer	B: producer
production company	none
sponsoring body	none
